1111111111111111111111111111111111,
1100000000010300000000000000000001,
1100000000010300000000000000000001,
1100000000011110000000000000000001,
1100000000000000100110000000000001,
1100011100000000000011000010000101,
1100100000000000000001100010100001,
1100000000110000000000111110010001,
1110000000000000000000011000011001,
1110000000000110000000000000000001,
1101000100000000000100000000000011,
1100000110000000100000111000000011,
1100001111000000000000111100000111,
1100000111100000000000111122122111,
1110010111110000000000111111111111,
1122222211111000000000111111111111,
1111111111111111111111111111111111,
1111111111111111111111111111111111,
1111111111111111111111111111111111,
